1mose=Første Mosebog=?=
2mose=Anden Mosebog=?=
3mose=Tredie Mosebog=?=
4mose=Fjerde Mosebog=?=
5mose=Femte Mosebog=?=
josua=Josuabogen=?=
dommer=Dommerbogen=?=
rut=Ruts Bog=?=
1samuel=Første Samuelsbog=?=
2samuel=Anden Samuelsbog=?=
1konge=Første Kongebog=?=
2konge=Anden Kongebog=?=
1kroen=Første Krønikebog=?=
2kroen=Anden Krønikebog=?=
ezra=Ezras Bog=?=
nehemias=Nehemias's Bog=?=
ester=Esters Bog=?=
job=Jobs Bog=?=
salme=Salmernes Bog=?=
ordsprog=Ordsprogenes Bog=?=
praed=Prædikerens Bog=?=
hoej=Højsangen=?=
esajas=Esajas's Bog=?=
jeremias=Jeremias's Bog=?=
klage=Klagesangene=?=
ezekiel=Ezekiels Bog=?=
daniel=Daniels Bog=?=
hoseas=Hoseas's Bog=?=
joel=Joels Bog=?=
amos=Amos's Bog=?=
obadias=Obadias's Bog=?=
jonas=Jonas's Bog=?=
mikas=Mikas Bog=?=
nahum=Nahums Bog=?=
habakkuk=Habakkuks Bog=?=
zefanias=Zefanias's Bog=?=
haggaj=Haggajs Bog=?=
zakarias=Zakarias's Bog=?=
malakias=Malakias's Bog=?=
matt=Matthæus-Evangeliet=?=
markus=Markus-Evangeliet=?=
lukas=Lukas-Evangeliet=?=
johannes=Johannes-Evangeliet=?=
apostlene=Apostlenes Gerninger=?=
rom=Paulus's Brev til Romerne=?=
1korint=Paulus's første Brev til Korinterne=?=
2korint=Paulus's andet Brev til Korinterne=?=
galaterne=Paulus's Brev til Galaterne=?=
efeserne=Paulus's Brev til Efeserne=?=
filipperne=Paulus's Brev til Filipperne=?=
kolossen=Paulus's Brev til Kolossenserne=?=
1tessa=Paulus's første Brev til Tessalonikerne=?=
2tessa=Paulus's andet Brev til Tessalonikerne=?=
1timoteus=Paulus's første Brev til Timetheus=?=
2timoteus=Paulus's andet Brev til Timetheus=?=
titus=Paulus's Brev til Titus=?=
filemon=Paulus's Brev til Filemon=?=
hebrae=Brevet til Hebræerne=?=
jakob=Jakobs Brev=?=
1peter=Peters første Brev=?=
2peter=Peters andet Brev=?=
1johannes=Johannes's første Brev=?=
2johannes=Johannes's andet Brev=?=
3johannes=Johannes's tredie Brev=?=
judas=Judas's Brev=?=
aabenbaringen=Johannes's Aabenbaring=?=
